16 82
0 0
5 5 5 5 14 7 7 7 7 7 7 7 15 5 5 5
5 4 4 4 11 7 7 7 7 7 7 7 12 4 4 5
5 4 4 4 11 7 7 7 7 7 7 7 12 4 4 5
5 4 4 4 11 7 7 7 7 7 7 7 12 4 4 5
5 4 4 4 11 7 7 7 7 7 7 7 12 4 4 5
5 4 4 4 10 8 8 8 6 8 8 8 9 4 4 5
5 4 4 4 4 4 4 4 4 4 4 4 4 4 4 5
5 4 4 4 4 4 4 4 4 4 4 4 4 4 4 5
5 4 4 4 4 4 4 4 4 4 4 4 4 4 4 5
5 5 4 5 4 4 5 4 4 4 4 4 4 4 4 5
5 5 4 4 4 5 5 4 4 5 4 4 4 5 4 5
5 4 4 4 4 4 4 4 4 4 4 4 4 4 4 5
5 4 5 4 4 4 4 5 4 4 4 4 4 5 5 5
5 4 4 4 5 4 4 4 4 4 4 5 4 4 4 5
5 5 4 4 4 4 5 4 4 5 4 5 4 4 4 5
5 4 5 4 4 4 4 4 4 4 4 5 5 5 5 5
5 4 5 5 4 4 4 4 4 4 5 5 5 5 5 5
5 4 5 4 5 4 4 4 4 5 4 5 4 5 4 5
5 5 4 5 4 5 4 4 5 4 5 4 5 4 5 5
5 4 5 4 5 4 4 4 4 5 4 5 4 5 4 5
5 5 4 5 4 5 4 4 5 4 5 4 5 4 5 5
5 4 5 4 5 4 4 4 4 5 4 5 4 5 4 5
5 5 4 5 4 5 4 4 5 4 5 4 5 4 5 5
5 4 5 4 5 4 4 4 4 5 4 5 4 5 4 5
4 5 4 5 4 5 4 4 5 4 5 4 5 4 5 5
3 16 3 16 3 16 0 0 16 3 16 3 16 3 16 3
3 3 16 3 16 3 0 0 3 16 3 16 3 16 3 3
3 16 3 16 3 16 0 0 16 3 16 3 16 3 16 3
3 3 16 3 16 3 0 0 3 16 3 16 3 16 3 3
3 16 3 16 3 16 0 0 16 3 16 3 16 3 16 3
3 3 16 3 16 3 0 0 3 16 3 16 3 16 3 3
3 16 3 16 3 16 0 0 16 3 16 3 16 3 16 3
3 3 16 3 16 3 0 0 3 16 3 16 3 16 3 3
3 16 3 16 3 16 0 0 16 3 16 3 16 3 16 3
3 3 3 3 3 3 0 0 3 3 3 3 3 3 3 3
3 3 3 3 3 3 0 0 3 3 3 3 3 3 3 3
3 3 3 3 3 3 0 0 3 3 3 3 3 3 3 3
3 3 3 3 3 3 0 0 3 3 3 3 3 3 3 3
3 3 3 3 3 3 0 0 3 3 3 3 3 3 3 3
3 3 3 3 3 3 0 0 3 3 3 3 3 3 3 3
3 3 3 3 3 3 0 0 3 3 3 3 3 3 3 3
3 3 3 3 3 3 0 0 3 3 3 3 3 3 3 3
3 3 3 3 3 3 0 0 3 3 3 3 3 3 3 3
3 3 3 3 3 3 0 0 3 3 3 3 3 3 3 3
3 3 3 3 3 3 0 0 3 3 3 3 3 3 3 3
3 3 0 0 0 3 0 0 3 3 3 3 3 0 0 3
3 3 0 3 3 3 0 0 3 0 0 0 3 3 3 3
3 0 0 3 0 0 0 0 3 0 3 0 0 0 3 3
3 0 3 3 0 3 3 3 0 0 3 3 3 3 0 3
3 2 2 2 2 3 0 0 3 3 0 0 0 0 0 3
3 2 2 2 2 3 0 0 0 0 0 3 3 0 3 3
3 2 2 2 2 3 3 3 3 3 0 0 3 0 3 3
3 2 2 2 2 0 0 0 0 0 3 0 3 0 3 3
3 2 2 2 2 3 3 3 3 0 0 0 3 0 3 3
3 3 3 3 3 0 0 0 3 3 3 3 3 0 0 3
3 3 0 0 3 0 3 0 3 0 3 0 0 3 0 3
3 3 0 3 3 0 3 0 3 0 0 0 3 3 0 3
3 3 0 0 0 0 3 0 3 3 0 3 0 0 0 3
3 3 3 0 3 3 3 0 0 0 0 3 0 3 0 3
3 3 3 0 3 3 0 0 0 3 0 3 0 3 0 3
3 3 0 0 0 3 0 3 3 0 0 3 0 0 0 3
3 3 0 3 0 3 0 0 0 3 3 3 0 3 0 3
3 3 0 3 0 0 0 3 0 3 3 3 0 3 0 3
3 0 0 3 3 3 3 3 0 0 0 0 0 3 0 3
3 0 3 3 3 0 3 3 3 3 0 3 3 3 3 3
3 0 0 0 0 0 0 0 0 3 3 3 3 3 3 3
3 3 3 3 3 3 3 3 0 3 3 3 0 0 3 3
3 0 0 0 0 0 0 0 0 3 3 3 0 3 3 3
3 0 3 3 3 3 3 3 0 3 0 0 0 0 0 3
3 0 3 0 0 0 3 3 0 3 3 3 3 3 0 3
3 0 3 0 3 0 3 3 0 0 0 0 0 3 0 3
3 0 3 0 3 0 3 3 3 3 3 3 0 3 0 3
3 3 3 0 3 0 0 0 0 0 3 3 0 0 0 3
3 0 0 0 3 3 3 3 3 0 3 3 0 3 3 3
3 0 3 0 3 3 3 3 3 0 0 0 0 0 0 3
3 0 3 0 3 3 3 3 3 3 3 3 0 3 0 3
3 0 3 0 3 3 3 2 2 2 2 2 2 3 0 3
3 0 3 0 3 3 3 2 2 2 2 2 2 3 0 3
3 0 3 0 0 0 3 2 2 2 2 2 2 3 0 3
3 0 3 3 3 3 3 2 2 2 2 2 2 3 0 3
3 0 0 0 0 0 0 2 2 2 2 2 2 3 0 3
3 3 3 3 3 3 3 3 3 3 3 3 3 3 3 3